NO ./assets/textures/north_wall.xpm
SO ./assets/textures/south_wall.xpm
WE ./assets/textures/west_wall.xpm
EA ./assets/textures/east_wall.xpm

F 220,100,0
C 225,30,255

        1111111111111111111111111
        1000000000110000000000001
        101100N001110000000000001
        1001000000000000000000001
1111111110110000011100000000000N1
111111111111111111111111111111111111111111111