NO ./assets/textures/no_texture
SO ./assets/textures/so_texture
WE ./assets/textures/we_texture
EA ./assets/textures/ea_texture

F 220,100,0
C 225,30,0

111111111
1000000011111111
10000000000000011111111111111111111111
10000000000000000000000000000000000001
10000000000000000111111111111111111111
100000001111111111
100000001
10001W111
11111