NO ./assets/textures/north_wall.xpm
SO ./assets/textures/south_wall.xpm
WE ./assets/textures/west_wall.xpm
EA ./assets/textures/east_wall.xpm

F 220,100,0
C 225,30,0

111111111
1000000011111111
1000000000000001111111111111111111E111
10000000000000000000000000000000000001
10000000000000000111111111111111111111
100000001111111111
100000001
100011111
11111