NO ./assets/textures/no_texture
SO ./assets/textures/so_texture
WE ./assets/textures/we_texture
EA ./assets/textures/ea_texture

F 220 ,  100 , 0
C 225 ,  030 , 0

 11111111111111
 10110110000011
 11111111111111
             11
 11111111111111
 1011N110000011
111111111111111
