NO ./assets/textures/no_texture
SO ./assets/textures/so_texture
WE ./assets/textures/we_texture
EA ./assets/textures/ea_texture

F 220,100,0
C 225,30,0

 1111111111111
 1011011000001
 1111111111111
 1111111111111
 1011N11000001
11111111111111
10110110 00001
11111111111111
10110110000001
11111111111111