NO ./assets/textures/north_wall.xpm
SO ./assets/textures/south_wall.xpm
WE ./assets/textures/west_wall.xpm
EA ./assets/textures/east_wall.xpm

F 220,100,0
C 225,30,0


           1
          101 
         10001
        1001001
       1001 1001
      1001   1001
     1001     1001
    10001     10001
   1001001   1000001
  1001 1001 1001 1001
 1001   1001001   1001
10E1     10001     1001
 1001   1001001   1001
  1001 1001 1001 1001
   1001001   1001001
    10001     10001
     101       101
      1         1

