NO ./assets/textures/no_texture
SO ./assets/textures/so_texture
WE ./assets/textures/we_texture
EA ./assets/textures/ea_texture

F 220,100,0
C 225,30,0


111111
10110
111111
1011N1
111111