NO ./assets/textures/north_wall.xpm
SO ./assets/textures/south_wall.xpm
WE ./assets/textures/west_wall.xpm
EA ./assets/textures/east_wall.xpm

F 220,100,0
C 225,30,0

        1111111111111111111111111         111111111111
        1000000000110000000000001111111111100000000001
        1011000001110000000000000000000000000000000001
        1001000000000000000000001111111111110111111101
111111111011000001110000000000001          101     101
100000000011000001110111110111111          101     101
11110111111111011100000010001              101     101
11110111111111011101010010001              10111111101
11000000110101011100000010001              10000000001
10000000000000001100000010001              111111111111
10000000000000001101010010001
11000001110101011111011110N0111
11110111111101011101111010001
11111111111101111111111111011
111111111111011111111111110111111         111111111111
111111111000000000110000000000001111111111100000000001
111111111011000001110000000000000000000000000000000001
111111111001000000000000000000001111111111110111111101
111111111011000001110000000000001          101     101
100000000011000001110111110111111          101     101
11110111111111011100000010001              101     101
11110111111111011101010010001              10111111101
11000000110101011100000010001              10000000001
10000000000000001100000010001              111111111111
10000000000000001101010010001
1100000111010101111101111000111
11110111111101011101111010001
11111111111101111111111111011
111111111111011111111111110111111         111111111111
111111111000000000110000000000001111111111100000000001
111111111011000001110000000000000000000000000000000001
111111111001000000000000000000001111111111110111111101
111111111011000001110000000000001          101     101
100000000011000001110111110111111          101     101
11110111111111011100000010001              101     101
11110111111111011101010010001              10111111101
11000000110101011100000010001              10000000001
10000000000000001100000010001              111111111111
10000000000000001101010010001
1100000111010101111101111000111
11110111111101011101111010001
11111111111101111111111111011
111111111111011111111111110111111         111111111111
111111111000000000110000000000001111111111100000000001
111111111011000001110000000000000000000000000000000001
111111111001000000000000000000001111111111110111111101
111111111011000001110000000000001          101     101
100000000011000001110111110111111          101     101
11110111111111011100000010001              101     101
11110111111111011101010010001              10111111101
11000000110101011100000010001              10000000001
10000000000000001100000010001              111111111111
10000000000000001101010010001
1100000111010101111101111000111
11110111 1110101 101111010001
11111111 1111111 111111111111