NO ./assets/textures/north_wall.xpm
SO ./assets/textures/south_wall.xpm
WE ./assets/textures/west_wall.xpm
EA ./assets/textures/east_wall.xpm

F 220,100,0
C 225,30,0

111111111111111111111
1000000000000000000S1
101111111111111111101
101               101
101               101
101               101
101               101
101111111111111111101
100000000000000000001
111111111111111111111