NO ./assets/textures/north_wall.xpm
SO ./assets/textures/south_wall.xpm
WE ./assets/textures/west_wall.xpm
EA ./assets/textures/east_wall.xpm

F 220,100,0
C 225,30,0

1111111111111111111111111111111111111111
10000000000000000000000000000000000000S1
1011111111111111111111111111111111111101
101                                  101
101                                  101
101                                  101
101                                  101
1011111111111111111111111111111111111101
1000000000000000000000000000000000000001
1111111111111111111111111111111111111111