111111111111111111111111111111111111  
100000000000001000000000000000000001  
101111111110101011111111111101111101  
101000000010000000000000001001000101  
101011111111111111111110101111110101  
101000000000000100000010100000010101  
111111111111101011111010111111010101  
100000000000001000001000000001010001  
101111111111111111101111111101011101  
101000000000000000100000000001000101  
101011111111101111111111111101110101  
101000000001001000000000000100000101  
101111111101101111111111101111110101  
1000000001001000N0000001000000000001  
101111111111101111111011111111111101  
101000000000001000001000000000000101  
101011111110111011101111111101110101  
101000000010000000000000001000010001  
111101111011111111111110101111111101  
100001000000000000000010000000000001  
101111111111111111111111111111111101  
100000000000000000000000000000000001  
100000000000000000000000000000000001  
111111111111111111111111111111111111

NO wall.xpm
SO wall.xpm
WE wall.xpm
EA wall.xpm
F 150,150,150
C 100,100,255