111111
100001
101101
100001
111111

NO wall.xpm
SO wall.xpm
WE wall.xpm
EA wall.xpm
F 150,150,150
C 100,100,255